XXXX|||||||||||XXXYX
XXX||||||||||||XXXXX
XXX|||||||||||||XXXX
XXXXXX|||||||||XXXXO
XXXXXXXXXXXXXXXXXXXX
XXXXXXXXXXXXXXX*****
XXXXXXXXXXX|||X*XXX?
XXXXXYXXXXXXX||XXXXX